W,W,W,W,W,W,W,W,W,W,W,W,W,W
W,0,0,0,W,W,0,0,0,0,0,0,0,W
W,0,0,0,0,W,0,W,0,0,0,0,0,W
W,0,0,0,0,W,0,W,0,0,0,0,0,W
P,0,0,0,0,W,0,W,W,W,W,0,0,D
W,0,0,0,0,W,0,0,0,0,W,0,0,W
W,0,0,0,0,W,W,W,W,0,W,0,0,W
W,0,0,0,0,0,0,0,0,0,W,0,0,W
W,W,W,W,W,W,W,W,W,W,W,W,W,W