W,W,W,W,W,W,W,W,W,W,W,W,W,W
W, , , ,W,W, , , , , , , ,W
W, ,P, , , , , , , , , , ,W
W, , , , , , , , , ,0, , ,W
W, , , , , , , , , , , , ,D
W, , , , ,W, , , , , , , ,W
W, , , , ,W,W,W, , , ,1, ,W
W, , , , , , , , , , , , ,W
W,W,W,W,W,W,W,W,W,W,W,W,W,W